13 13 13 13 13 13 13 13 13 13 13 13 13 13 13 13 13 13 13 13 13 13 13 13 13 13 13 13 13 13 13 13 13 13 13 13 13 13 13 13 13 13 13 13 13 13 13 13 13 13 
13 13 13 13 13 13 13 13 13 13 13 13 13 13 13 13 13 13 13 13 13 13 13 13 13 13 13 13 13 13 13 13 13 13 13 13 13 13 13 13 13 13 13 13 13 13 13 13 13 13 
13 13 13 13 13 13 13 13 13 13 13 13 13 13 13 13 13 13 13 13 13 13 13 13 13 13 13 13 13 13 13 13 13 13 13 13 13 13 13 13 13 13 13 13 13 13 13 13 13 13 
13 13 13 13 13 13 13 13 13 13 13 13 13 13 13 13 13 13 13 13 13 13 13 13 13 13 13 13 13 13 13 13 13 13 13 13 13 13 13 13 13 13 13 13 13 13 13 13 13 13  
13 13 13 13 13 13 13 13 13 13 13 13 13 13 13 13 13 13 13 13 13 13 13 13 13 13 13 13 13 13 13 13 13 13 13 13 13 13 13 13 13 13 13 13 13 13 13 13 13 13 
13 13 13 13 13 13 13 13 13 13 13 13 13 13 13 13 13 13 13 13 13 13 13 13 13 13 13 13 13 13 13 13 13 13 13 13 13 13 13 13 13 13 13 13 13 13 13 13 13 13  
13 13 13 13 13 13 22 20 20 20 20 20 20 20 23 13 13 13 22 20 20 20 20 20 20 20 20 23 13 13 13 22 20 20 20 20 20 20 20 20 20 20 23 13 13 13 13 13 13 13 
13 13 13 13 13 13 18 10 40 40 40 40 40 10 19 20 20 20 21 10 10 10 11 10 10 10 10 19 20 20 20 21 10 10 35 33 33 33 33 33 33 36 17 13 13 13 13 13 13 13 
13 13 13 13 13 13 18 10 40 39 39 39 40 10 10 10 10 10 10 10 10 14 15 15 15 16 10 10 10 10 10 10 10 10 31 26 26 26 26 26 26 30 17 13 13 13 13 13 13 13
13 13 13 13 13 13 18 10 40 39 39 39 40 10 10 10 10 10 10 10 10 17 13 13 13 18 10 10 10 10 10 10 10 10 31 26 26 26 26 26 26 30 17 13 13 13 13 13 13 13 
13 13 13 13 13 13 18 10 40 39 39 39 40 10 10 10 10 10 10 10 10 17 13 13 13 18 11 10 10 10 10 10 10 10 31 26 26 26 26 26 26 30 17 13 13 13 13 13 13 13 
13 13 13 13 13 13 18 10 40 39 39 39 40 10 10 10 10 10 10 10 10 19 20 20 20 21 10 10 10 10 10 10 10 10 31 26 26 26 26 26 26 30 17 13 13 13 13 13 13 13 
13 13 13 13 13 13 18 10 40 40 39 40 40 10 10 10 10 10 10 10 11 10 35 33 36 10 10 10 10 10 10 10 10 10 37 28 28 29 26 27 28 38 17 13 13 13 13 13 13 13 
13 13 13 13 13 13 18 10 10 10 10 10 10 10 10 10 10 10 10 10 10 10 31 26 30 10 10 10 10 10 10 10 10 10 10 10 10 31 26 30 14 15 25 13 13 13 13 13 13 13 
13 13 13 13 13 13 18 10 10 10 10 10 10 10 10 10 10 10 10 10 10 10 31 26 30 10 10 10 10 10 10 10 10 10 10 10 10 31 26 30 17 13 13 13 13 13 13 13 13 13 
13 13 13 13 13 13 24 15 16 10 10 10 10 10 10 10 10 10 10 10 10 10 31 26 30 10 10 10 10 10 10 10 10 10 10 10 10 31 26 30 17 13 13 13 13 13 13 13 13 13 
13 13 13 13 13 13 13 13 18 10 10 10 10 10 10 10 10 10 10 10 10 10 31 26 30 10 10 10 10 10 10 10 10 10 10 10 10 31 26 30 17 13 13 13 13 13 13 13 13 13 
13 13 13 13 13 13 13 22 21 10 10 10 10 10 10 10 10 10 10 10 10 10 31 26 30 10 10 10 10 10 10 10 10 10 10 35 33 34 26 30 17 13 13 13 13 13 13 13 13 13 
13 13 13 13 13 13 13 18 10 10 10 10 10 10 10 10 10 10 10 10 10 10 31 26 30 10 10 10 10 10 10 10 10 10 10 31 26 26 26 30 17 13 13 13 13 13 13 13 13 13 
13 13 13 13 13 13 13 18 10 10 10 10 10 10 10 10 10 10 10 10 10 10 31 26 30 10 10 10 10 10 10 10 10 10 10 31 26 27 28 38 17 13 13 13 13 13 13 13 13 13 
13 13 13 13 13 13 13 18 10 10 10 10 10 35 33 33 33 33 33 33 33 33 34 26 32 33 33 33 33 33 33 33 33 33 33 34 26 30 10 10 17 13 13 13 13 13 13 13 13 13 
13 13 13 13 13 13 13 18 10 10 10 10 11 31 26 26 26 26 26 26 26 26 26 26 26 26 26 26 26 26 26 26 26 26 26 26 26 30 10 14 25 13 13 13 13 13 13 13 13 13 
13 13 13 13 13 13 13 18 10 10 10 10 10 37 28 28 28 28 28 28 28 28 29 26 27 28 28 28 28 28 28 28 28 28 28 29 26 30 10 17 13 13 13 13 13 13 13 13 13 13 
13 13 13 13 13 13 13 24 16 10 10 10 10 10 10 10 10 10 10 10 10 10 31 26 30 10 10 10 10 10 10 10 10 10 10 31 26 30 10 17 13 13 13 13 13 13 13 13 13 13 
13 13 13 13 13 13 13 13 18 10 10 10 10 10 10 10 10 10 10 10 10 10 31 26 30 10 10 10 10 10 10 10 10 10 10 31 26 30 11 17 13 13 13 13 13 13 13 13 13 13 
13 13 13 13 13 13 13 22 21 10 10 10 10 10 10 10 10 10 10 10 10 10 31 26 30 10 10 10 10 10 10 10 10 10 10 31 26 30 10 17 13 13 13 13 13 13 13 13 13 13 
13 13 13 13 13 13 13 18 10 10 10 10 10 10 10 10 10 10 10 10 10 10 31 26 30 10 10 10 10 10 10 10 10 10 10 31 26 30 10 17 13 13 13 13 13 13 13 13 13 13 
13 13 13 13 13 13 13 18 10 10 10 10 10 10 10 10 10 10 10 10 10 10 31 26 30 10 10 10 10 10 10 10 10 10 10 31 26 30 10 17 13 13 13 13 13 13 13 13 13 13 
13 13 13 13 13 13 13 18 10 10 10 10 10 10 10 10 10 10 10 10 10 10 31 26 30 10 10 10 10 10 10 10 10 10 10 31 26 30 10 17 13 13 13 13 13 13 13 13 13 13 
13 13 13 13 13 13 13 18 10 10 10 10 10 10 10 10 10 10 10 10 10 10 31 26 30 10 10 10 10 10 10 10 10 10 10 37 28 38 10 17 13 13 13 13 13 13 13 13 13 13 
13 13 13 13 13 13 13 18 10 10 11 10 10 10 10 10 10 10 10 10 10 10 31 26 30 10 10 10 10 10 10 10 10 10 10 10 10 10 14 25 13 13 13 13 13 13 13 13 13 13 
13 13 13 13 13 13 13 24 16 10 10 10 10 10 10 10 10 10 10 10 10 10 31 26 30 10 10 10 10 10 10 10 10 10 10 10 10 10 17 13 13 13 13 13 13 13 13 13 13 13 
13 13 13 13 13 13 13 13 18 10 10 10 10 11 10 10 10 10 10 10 10 10 31 26 30 10 10 10 10 10 10 10 10 10 10 10 10 10 17 13 13 13 13 13 13 13 13 13 13 13 
13 13 13 13 13 13 13 13 18 11 10 10 10 10 10 10 10 10 10 10 10 10 31 26 30 10 10 10 10 10 10 10 10 10 10 10 10 11 17 13 13 13 13 13 13 13 13 13 13 13 
13 13 13 13 13 13 13 13 18 10 10 10 10 10 10 10 10 10 10 10 10 10 31 26 30 10 10 10 10 10 10 10 10 10 10 10 10 10 17 13 13 13 13 13 13 13 13 13 13 13 
13 13 13 13 13 13 13 22 21 10 10 10 10 10 10 10 10 10 10 10 10 10 37 28 38 10 10 10 10 10 10 10 10 10 10 11 10 10 19 23 13 13 13 13 13 13 13 13 13 13 
13 13 13 13 13 13 13 18 10 10 10 10 10 10 10 10 10 10 10 10 10 10 10 10 10 10 10 10 10 10 10 10 10 10 10 10 10 10 10 19 23 13 13 13 13 13 13 13 13 13 
13 13 13 13 13 13 13 18 10 10 10 10 10 10 10 10 10 10 10 10 10 10 10 10 10 10 10 10 10 10 10 10 10 10 10 10 10 10 10 10 17 13 13 13 13 13 13 13 13 13 
13 13 13 13 13 13 13 18 10 10 10 10 10 10 10 10 10 10 10 11 10 10 10 10 10 11 10 10 10 10 10 10 10 10 10 10 10 11 10 10 17 13 13 13 13 13 13 13 13 13 
13 13 13 13 13 13 13 18 10 10 10 10 10 10 10 10 10 10 10 10 11 10 10 10 10 10 10 10 10 10 10 10 10 10 10 10 10 10 10 10 17 13 13 13 13 13 13 13 13 13 
13 13 13 13 13 13 13 18 10 10 10 10 10 10 10 10 10 10 10 10 10 10 10 10 10 10 10 10 10 10 10 10 10 10 10 10 10 10 10 10 17 13 13 13 13 13 13 13 13 13 
13 13 13 13 13 13 13 18 10 10 10 10 10 10 10 14 15 15 16 10 10 10 10 10 11 10 10 14 15 15 16 10 10 10 10 10 10 10 11 10 17 13 13 13 13 13 13 13 13 13 
13 13 13 13 13 13 13 18 10 10 10 10 10 10 14 25 13 13 24 16 10 10 10 10 10 10 14 25 13 13 18 10 10 10 10 10 10 10 10 10 17 13 13 13 13 13 13 13 13 13 
13 13 13 13 13 13 13 24 15 15 15 15 15 15 25 13 13 13 13 24 15 15 15 15 15 15 25 13 13 13 24 16 10 11 10 10 10 10 14 15 25 13 13 13 13 13 13 13 13 13 
13 13 13 13 13 13 13 13 13 13 13 13 13 13 13 13 13 13 13 13 13 13 13 13 13 13 13 13 13 13 13 24 15 15 15 15 15 15 25 13 13 13 13 13 13 13 13 13 13 13 
13 13 13 13 13 13 13 13 13 13 13 13 13 13 13 13 13 13 13 13 13 13 13 13 13 13 13 13 13 13 13 13 13 13 13 13 13 13 13 13 13 13 13 13 13 13 13 13 13 13 
13 13 13 13 13 13 13 13 13 13 13 13 13 13 13 13 13 13 13 13 13 13 13 13 13 13 13 13 13 13 13 13 13 13 13 13 13 13 13 13 13 13 13 13 13 13 13 13 13 13 
13 13 13 13 13 13 13 13 13 13 13 13 13 13 13 13 13 13 13 13 13 13 13 13 13 13 13 13 13 13 13 13 13 13 13 13 13 13 13 13 13 13 13 13 13 13 13 13 13 13 
13 13 13 13 13 13 13 13 13 13 13 13 13 13 13 13 13 13 13 13 13 13 13 13 13 13 13 13 13 13 13 13 13 13 13 13 13 13 13 13 13 13 13 13 13 13 13 13 13 13 
13 13 13 13 13 13 13 13 13 13 13 13 13 13 13 13 13 13 13 13 13 13 13 13 13 13 13 13 13 13 13 13 13 13 13 13 13 13 13 13 13 13 13 13 13 13 13 13 13 13 