13 13 13 13 13 13 13 13 13 13 13 13 13 13 13 13 13 13 13 13 13 13 13 13 13 13 13 13 13 13 13 13 13 13 13 13 13 13 13 13 13 13 13 13 13 13 13 13 13 13 
13 13 13 13 13 13 13 13 13 13 13 13 13 13 13 13 13 13 13 13 13 13 13 13 13 13 13 13 13 13 13 13 13 13 13 13 13 13 13 13 13 13 13 13 13 13 13 13 13 13 
13 13 13 13 13 13 13 13 13 13 13 13 13 13 13 13 13 13 13 13 13 13 13 13 13 13 13 13 13 13 13 13 13 13 13 13 13 13 13 13 13 13 13 13 13 13 13 13 13 13 
13 13 13 13 13 13 13 13 13 13 13 13 13 13 13 13 13 13 13 13 13 13 13 13 13 13 13 13 13 13 13 13 13 13 13 13 13 13 13 13 13 13 13 13 13 13 13 13 13 13  
13 13 13 13 13 13 13 13 13 13 13 13 13 13 13 13 13 13 13 13 13 13 13 13 13 13 13 13 13 13 13 13 13 13 13 13 13 13 13 13 13 13 13 13 13 13 13 13 13 13 
13 13 13 13 13 13 13 13 13 13 13 13 13 13 13 13 13 13 13 13 13 13 13 13 13 13 13 13 13 13 13 13 13 13 13 13 13 13 13 13 13 13 13 13 13 13 13 13 13 13  
13 13 13 13 13 13 17 17 17 17 17 17 17 17 17 13 13 13 17 17 17 17 17 17 17 17 17 17 13 13 13 17 17 17 17 17 17 17 17 17 17 17 17 13 13 13 13 13 13 13 
13 13 13 13 13 13 17 10 40 40 40 40 40 10 17 17 17 17 17 10 10 10 11 10 10 10 10 17 17 17 17 17 10 10 35 33 33 33 33 33 33 36 17 13 13 13 13 13 13 13 
13 13 13 13 13 13 17 10 40 39 39 39 40 10 10 10 10 10 10 10 10 14 15 15 15 16 10 10 10 10 10 10 10 10 31 17 17 17 17 17 17 30 17 13 13 13 13 13 13 13
13 13 13 13 13 13 17 10 40 39 39 39 40 10 10 10 10 10 10 10 10 17 13 13 13 17 10 10 10 10 10 10 10 10 31 17 17 17 17 17 17 30 17 13 13 13 13 13 13 13 
13 13 13 13 13 13 17 10 40 39 39 39 40 10 10 10 10 10 10 10 10 17 13 13 13 17 11 10 10 10 10 10 10 10 31 17 17 17 17 17 17 30 17 13 13 13 13 13 13 13 
13 13 13 13 13 13 17 10 40 39 39 39 40 10 10 10 10 10 10 10 10 17 17 17 17 17 10 10 10 10 10 10 10 10 31 17 17 17 17 17 17 30 17 13 13 13 13 13 13 13 
13 13 13 13 13 13 17 10 40 40 39 40 40 10 10 10 10 10 10 10 11 10 35 33 36 10 10 10 10 10 10 10 10 10 37 17 17 29 17 17 17 38 17 13 13 13 13 13 13 13 
13 13 13 13 13 13 17 10 10 10 10 10 10 10 10 10 10 10 10 10 10 10 31 17 30 10 10 10 10 10 10 10 10 10 10 10 10 31 17 30 14 15 17 13 13 13 13 13 13 13 
13 13 13 13 13 13 17 10 10 10 10 10 10 10 10 10 10 10 10 10 10 10 31 17 30 10 10 10 10 10 10 10 10 10 10 10 10 31 17 30 17 13 13 13 13 13 13 13 13 13 
13 13 13 13 13 13 17 15 16 10 10 10 10 10 10 10 10 10 10 10 10 10 31 17 30 10 10 10 10 10 10 10 10 10 10 10 10 31 17 30 17 13 13 13 13 13 13 13 13 13 
13 13 13 13 13 13 13 13 17 10 10 10 10 10 10 10 10 10 10 10 10 10 31 17 30 10 10 10 10 10 10 10 10 10 10 10 10 31 17 30 17 13 13 13 13 13 13 13 13 13 
13 13 13 13 13 13 13 17 17 10 10 10 10 10 10 10 10 10 10 10 10 10 31 17 30 10 10 10 10 10 10 10 10 10 10 35 33 34 17 30 17 13 13 13 13 13 13 13 13 13 
13 13 13 13 13 13 13 17 10 10 10 10 10 10 10 10 10 10 10 10 10 10 31 17 30 10 10 10 10 10 10 10 10 10 10 31 17 17 17 30 17 13 13 13 13 13 13 13 13 13 
13 13 13 13 13 13 13 17 10 10 10 10 10 10 10 10 10 10 10 10 10 10 31 17 30 10 10 10 10 10 10 10 10 10 10 31 17 17 17 38 17 13 13 13 13 13 13 13 13 13 
13 13 13 13 13 13 13 17 10 10 10 10 10 35 33 33 33 33 33 33 33 33 34 17 32 33 33 33 33 33 33 33 33 33 33 34 17 30 10 10 17 13 13 13 13 13 13 13 13 13 
13 13 13 13 13 13 13 17 10 10 10 10 11 31 17 17 17 17 17 17 17 17 17 17 17 17 17 17 17 17 17 17 17 17 17 17 17 30 10 14 17 13 13 13 13 13 13 13 13 13 
13 13 13 13 13 13 13 17 10 10 10 10 10 37 17 17 17 17 17 17 17 17 29 17 17 17 17 17 17 17 17 17 17 17 17 29 17 30 10 17 13 13 13 13 13 13 13 13 13 13 
13 13 13 13 13 13 13 17 16 10 10 10 10 10 10 10 10 10 10 10 10 10 31 17 30 10 10 10 10 10 10 10 10 10 10 31 17 30 10 17 13 13 13 13 13 13 13 13 13 13 
13 13 13 13 13 13 13 13 17 10 10 10 10 10 10 10 10 10 10 10 10 10 31 17 30 10 10 10 10 10 10 10 10 10 10 31 17 30 11 17 13 13 13 13 13 13 13 13 13 13 
13 13 13 13 13 13 13 17 17 10 10 10 10 10 10 10 10 10 10 10 10 10 31 17 30 10 10 10 10 10 10 10 10 10 10 31 17 30 10 17 13 13 13 13 13 13 13 13 13 13 
13 13 13 13 13 13 13 17 10 10 10 10 10 10 10 10 10 10 10 10 10 10 31 17 30 10 10 10 10 10 10 10 10 10 10 31 17 30 10 17 13 13 13 13 13 13 13 13 13 13 
13 13 13 13 13 13 13 17 10 10 10 10 10 10 10 10 10 10 10 10 10 10 31 17 30 10 10 10 10 10 10 10 10 10 10 31 17 30 10 17 13 13 13 13 13 13 13 13 13 13 
13 13 13 13 13 13 13 17 10 10 10 10 10 10 10 10 10 10 10 10 10 10 31 17 30 10 10 10 10 10 10 10 10 10 10 31 17 30 10 17 13 13 13 13 13 13 13 13 13 13 
13 13 13 13 13 13 13 17 10 10 10 10 10 10 10 10 10 10 10 10 10 10 31 17 30 10 10 10 10 10 10 10 10 10 10 37 17 38 10 17 13 13 13 13 13 13 13 13 13 13 
13 13 13 13 13 13 13 17 10 10 11 10 10 10 10 10 10 10 10 10 10 10 31 17 30 10 10 10 10 10 10 10 10 10 10 10 10 10 14 17 13 13 13 13 13 13 13 13 13 13 
13 13 13 13 13 13 13 17 16 10 10 10 10 10 10 10 10 10 10 10 10 10 31 17 30 10 10 10 10 10 10 10 10 10 10 10 10 10 17 13 13 13 13 13 13 13 13 13 13 13 
13 13 13 13 13 13 13 13 17 10 10 10 10 11 10 10 10 10 10 10 10 10 31 17 30 10 10 10 10 10 10 10 10 10 10 10 10 10 17 13 13 13 13 13 13 13 13 13 13 13 
13 13 13 13 13 13 13 13 17 11 10 10 10 10 10 10 10 10 10 10 10 10 31 17 30 10 10 10 10 10 10 10 10 10 10 10 10 11 17 13 13 13 13 13 13 13 13 13 13 13 
13 13 13 13 13 13 13 13 17 10 10 10 10 10 10 10 10 10 10 10 10 10 31 17 30 10 10 10 10 10 10 10 10 10 10 10 10 10 17 13 13 13 13 13 13 13 13 13 13 13 
13 13 13 13 13 13 13 17 17 10 10 10 10 10 10 10 10 10 10 10 10 10 37 17 38 10 10 10 10 10 10 10 10 10 10 11 10 10 17 17 13 13 13 13 13 13 13 13 13 13 
13 13 13 13 13 13 13 17 10 10 10 10 10 10 10 10 10 10 10 10 10 10 10 10 10 10 10 10 10 10 10 10 10 10 10 10 10 10 10 17 17 13 13 13 13 13 13 13 13 13 
13 13 13 13 13 13 13 17 10 10 10 10 10 10 10 10 10 10 10 10 10 10 10 10 10 10 10 10 10 10 10 10 10 10 10 10 10 10 10 10 17 13 13 13 13 13 13 13 13 13 
13 13 13 13 13 13 13 17 10 10 10 10 10 10 10 10 10 10 10 11 10 10 10 10 10 11 10 10 10 10 10 10 10 10 10 10 10 11 10 10 17 13 13 13 13 13 13 13 13 13 
13 13 13 13 13 13 13 17 10 10 10 10 10 10 10 10 10 10 10 10 11 10 10 10 10 10 10 10 10 10 10 10 10 10 10 10 10 10 10 10 17 13 13 13 13 13 13 13 13 13 
13 13 13 13 13 13 13 17 10 10 10 10 10 10 10 10 10 10 10 10 10 10 10 10 10 10 10 10 10 10 10 10 10 10 10 10 10 10 10 10 17 13 13 13 13 13 13 13 13 13 
13 13 13 13 13 13 13 17 10 10 10 10 10 10 10 14 15 15 16 10 10 10 10 10 11 10 10 14 15 15 16 10 10 10 10 10 10 10 11 10 17 13 13 13 13 13 13 13 13 13 
13 13 13 13 13 13 13 17 10 10 10 10 10 10 14 17 13 13 17 16 10 10 10 10 10 10 14 17 13 13 17 10 10 10 10 10 10 10 10 10 17 13 13 13 13 13 13 13 13 13 
13 13 13 13 13 13 13 17 15 15 15 15 15 15 17 13 13 13 13 17 15 15 15 15 15 15 17 13 13 13 17 16 10 11 10 10 10 10 14 15 17 13 13 13 13 13 13 13 13 13 
13 13 13 13 13 13 13 13 13 13 13 13 13 13 13 13 13 13 13 13 13 13 13 13 13 13 13 13 13 13 13 17 15 15 15 15 15 15 17 13 13 13 13 13 13 13 13 13 13 13 
13 13 13 13 13 13 13 13 13 13 13 13 13 13 13 13 13 13 13 13 13 13 13 13 13 13 13 13 13 13 13 13 13 13 13 13 13 13 13 13 13 13 13 13 13 13 13 13 13 13 
13 13 13 13 13 13 13 13 13 13 13 13 13 13 13 13 13 13 13 13 13 13 13 13 13 13 13 13 13 13 13 13 13 13 13 13 13 13 13 13 13 13 13 13 13 13 13 13 13 13 
13 13 13 13 13 13 13 13 13 13 13 13 13 13 13 13 13 13 13 13 13 13 13 13 13 13 13 13 13 13 13 13 13 13 13 13 13 13 13 13 13 13 13 13 13 13 13 13 13 13 
13 13 13 13 13 13 13 13 13 13 13 13 13 13 13 13 13 13 13 13 13 13 13 13 13 13 13 13 13 13 13 13 13 13 13 13 13 13 13 13 13 13 13 13 13 13 13 13 13 13 
13 13 13 13 13 13 13 13 13 13 13 13 13 13 13 13 13 13 13 13 13 13 13 13 13 13 13 13 13 13 13 13 13 13 13 13 13 13 13 13 13 13 13 13 13 13 13 13 13 13 